Date,Transaction Description,Amount,Balance
2024-09-10,OPENING BALANCE,0.00,5000.00
2024-09-10,POS PURCHASE - WOOLWORTHS,-250.00,4750.00
2024-09-11,SALARY DEPOSIT,8500.00,13250.00
2024-09-11,DEBIT ORDER - DSTV,-899.00,12351.00
2024-09-12,ATM WITHDRAWAL,-500.00,11851.00
2024-09-12,INTERNET TRANSFER - RENT,-12000.00,-149.00
2024-09-12,REVERSAL - INTERNET TRANSFER,12000.00,11851.00